*************************************************************
*  *        *        *     *  *        *  *  *              *
*  *  *******  *  *  *  *  *  *******  *  *  *  *  *******  *
*           *  *  *  *  *  *     *  *     *     *  *  *     *
*  ****  ****  ****  ****  *  ****  *  ****  ****  *  *******
*  *        *  *     *        *     *  *        *     *     *
*  *  *******  *  *  *  *  ****  *  *  *******  *******  ****
*  *     *     *  *     *  *     *     *  *     *  *  *  *  *
*  ****  ****  ****  *  *************  *  *  *  *  *  *  *  *
*  *  *  *     *     *  *           *     *  *  *        *  *
*  *  **********  ****  ****  *******  *  *  *  *******  *  *
*     *  *  *     *  *              *  *  *  *     *        *
*  ****  *  *******  ****  ****  *******  *******  *  *******
*  *     *     *     *  *  *              *  *           *  *
*  *  *******  *  ****  ****  *  ****  *  *  **********  *  *
*                 *     *     *  *     *        *  *  *     *
*******  *  *  *******  *******  *  ****  *  *  *  *  *  ****
*  *     *  *     *              *     *  *  *              *
*  ****  ****  *  **********  **********  ****  ****  *  ****
*  *        *  *     *        *     *        *  *     *  *  *
*  ****  *******  *******  *******  *******  *************  *
*        *  *  *  *     *     *  *  *     *     *     *     *
*  *******  *  ****  *  ****  *  *  *  *************  ****  *
*        *        *  *        *  *  *                 *  *  *
*  *  *  *  *  ****  *  *******  *  *******  ****  *  *  *  *
*  *  *     *     *  *        *  *  *        *  *  *     *  *
*  *  *******  *******  ****  *  *  ****  *  *  ****  ****  *
*  *     *           *     *        *     *  *     *        *
****  ****  *  *************  *******  ****  *  *  ****  *  *
*  *  *  *  *        *  *           *     *     *     *  *  *
*  ****  *  *  ****  *  *  ****  ****  *******  *  ****  ****
*        *  *     *           *     *        *  *     *     *
*  *  *************  *  *******  ****  ****************  ****
*  *  *           *  *     *        *  *     *        *     *
*  *******  ****  *  *************  *  ****  *  ****  *  ****
*           *              *  *     *              *  *  *  *
*  *******  *  *  *  *  *  *  ****  *  *  *  ****  *******  *
*     *  *  *  *  *  *  *  *  *        *  *  *  *  *  *  *  *
*  ****  *******  ****  *  *  ****  *  *******  *  *  *  *  *
*     *           *     *     *     *        *               
**********************************************************   
1
1